stone.xpm
cobblestone.xpm
stone_brick.xpm
mossy_stone_brick.xpm
110,30,30
30,110,30
111111111
100000001
100010001
10000E001
110000111
110111111
110100011
110101011
110100011
110000111
111111111